NO ./textures/simple/north_brown.png
SO ./textures/simple/south_sienna.png
WE ./textures/simple/west_burlywood.png
EA ./textures/simple/east_peru.png

F 40,40,40
C 80,80,120

111111111111111111111111111111
100000000000000000000000000001
100000000000000000000000000001
100011111001111111111100111001
100010001000000000000100101001
100010001000000000000100101001
100010001001111001111100101001
100000001001000001000000101001
100000001001000001000000101001
100011111001000001000011111001
100000000001000001000000000001
100000000001000001000000000001
100111111111000001111111111001
100100000000000N0000000000001
100100000000000000000000000001
100100011111111111111111000001
100100010000000000000001000001
100100010000000000000001000001
100000010011111111110001000001
100000010010000000010001000001
100000010010000000010001000001
100111110010011111010001111001
100000000010010001010000001001
100000000010010001010000001001
100011111110010001011111001001
100000000000010001000001001001
100000000000010001000001001001
100111111111110001111101001001
100000000000000000000100000001
111111111111111111111111111111
