NO ./textures/simple/north_brown.png
SO ./textures/simple/south_sienna.png
WE ./textures/simple/west_burlywood.png
EA ./textures/simple/east_peru.png

F 50,50,50
C 135,206,235

1111111111111111
1000000000000001
1000000000000001
1000000000000001
1000000N00000001
1000000000000001
1000000000000001
1000000000000001
1000111111000001
1000100001000001
1000100001000001
1000000000000001
1111111111111111
